7 9
XXXXXXXXX
X       X
XXXX XX X
X.......X
X.XX XX.X
XGX   S.X
XXXXXXXXX
